EWWDEWWWWWW
EEEWEWWEE
WWEEEEEEWWE
WWWWWWWEWWE
EEEEEWEEWWE
EWWWEEEWEEE
EEEAWWWWEWW
WWWEEEEEEWW