EWWDEWWWWWW
EEEWEWWEEEE
WWEEEEEEWWE
WWWWWWWEWWE
EEEEEWEEWWE
EWWWEEEWEEE
EEEAWWWWEWW
WWWEEEEEEWW